Air conditioner,6798,9236,5998,7635,7036,36703
Blender,404,498,439,474,555,2370
Ceiling fan,1459,1310,1321,1742,1259,7091
Coffee grinder,551,652,714,613,606,3136
Dishwasher,5096,3122,4614,5709,2991,21532
Iron,358,403,319,364,412,1856
Microwave,671,922,904,782,887,4166
Oven,5351,5021,4027,4482,6960,25841
Refrigerator,10350,7325,10397,12488,7494,48054
Toaster,555,387,464,543,354,2303
Vacuum Cleaner,2516,2552,2677,2397,2518,12660
Washing Machine,6990,7472,6975,8683,8927,39047